
SO textures/backrooms.xpm
NO textures/backrooms.xpm
WE textures/backrooms.xpm
EA             textures/backrooms.xpm

F   255,255,153




C 255,255,102













 111111111111
1N1111000001111111
111111111111111111111111

 111111111111