   NO                  ./textures/wood_strips.xpm




SO ./path_to_the_south_texture.xpm


WE ./path_to_the_west_texture.xpm
EA lltextures/wood_stripsss.xpm

C   9,8,3

F 225,255,2
1
1111111111111111111111111111111111
1000000000010000000000001111111111111111111111111
l000001100001000110000000100000000000000000000001
1111111100000000110000001110000000000000000000001
1000001 1111111011111111  10000000000000000000001
1000001 10000000000001    11111101000100000000001
1000001110000000000001    10000001000100000000001
1000000000100000000001    10000001000100000000001
1000001110000000000001    11111101000100S00000001
1000001 1000N   000001    10000001000100000000001
1000001 11111111111111    10000001111100000000001
1000001                   10000000000000000000001
1000001                   10000000000000000000001
1000001                   10000000000000000000001
1000001                   11111111111111111111111
1000001   
10000111111111111111111111111111111111111
10000011000000000000001100000001110000001
10000000000000000000000000000000000000001
10000011000000000000001100000001100000011
11111111111111111111111111111111111111111
1000000000000000
1111111111111111