
SO textures/backrooms.xpm
NO textures/backrooms.xpm
WE textures/backrooms.xpm
EA             textures/backrooms.xpm

F   255,255,153




C 255,255,102





111111111111111111111   
11001110000000000011    
11000110000000001111    
1100011000001110000111  
1111110000000001111     
111110000N00001111111   
111111000000111111      
111111100000111111111   
110000000000000011111   
10000000000000011111111 
111111111111111111111   

